001 000 000 000 000 000 000 000 000 000 000 000 000 000 000 000 015 015 015 015
001 001 001 001 001 001 001 000 001 001 001 001 001 001 000 001 000 000 000 000
000 001 001 001 003 001 001 000 001 000 000 000 000 001 000 001 000 011 012 000
000 001 001 001 001 001 001 000 001 000 001 001 000 001 000 001 000 014 013 000
000 001 001 001 001 001 001 000 001 000 001 001 000 001 000 001 000 000 000 000
000 001 001 001 002 003 001 000 001 000 001 001 003 001 001 003 001 003 001 000
000 001 003 001 001 001 001 001 001 001 001 001 001 001 001 001 003 001 001 000
000 001 001 001 001 001 001 001 001 001 001 001 001 001 001 001 001 001 001 000
000 001 002 001 003 001 001 001 002 001 001 001 001 001 001 001 001 001 001 000
000 001 001 001 001 001 001 001 001 001 007 008 008 008 008 008 003 001 001 000
000 001 001 001 001 001 001 001 001 001 001 001 001 001 008 008 001 001 001 000
000 001 001 001 001 004 001 001 001 001 001 001 001 001 001 001 001 001 001 000
000 001 001 001 001 001 005 005 005 005 001 001 001 002 002 001 001 001 001 000
000 001 002 001 001 001 005 001 001 005 001 001 001 001 001 001 001 007 007 000
000 001 001 001 001 001 005 001 001 001 001 001 001 001 001 001 010 007 007 000
000 001 001 001 005 004 005 001 001 001 001 001 006 001 001 001 007 007 007 000
000 001 001 001 005 001 005 001 001 001 001 001 001 001 001 001 007 007 007 000
000 001 001 001 005 001 005 001 001 001 004 004 006 001 001 001 007 001 001 000
000 005 005 005 005 001 005 001 001 001 001 001 001 001 001 001 001 001 001 000
000 000 000 000 000 000 000 000 000 000 000 000 000 000 000 000 000 000 000 000